##########
#00000000#
#000000000
#000000000
#00000000#
#0000#####
#0000#000#
#0000#000#
#0000##00#
#00000000#
#00000000#
#00000000#
#00000000#
##########